################################################...########################.....##########
############...###############..################.............############.......##########
###########.........##########...####......###.................#########........##########
##########...........#########.............##..##..............#########.......###########
###...#..............#############.....#........#####...........##############..##..######
###..........###......#############.............#####...........###############.......####
###..........###......###################........#####..........################......####
###.........#######...##################..........####.......###################.......###
###.........#######..##################............#################....#########......###
###.........########.#################.................###########......########.......###
##..........########.#################...#.............###########......#######........###
##.......###########..#################...#...#........###########......######.........###
##........##########..##################..#####......#.###########......######.........###
###.......##########..##################...#...........##########..##.....##....#......###
###.##.....#############################............############..#####................###
###..##.....############......##########.....##....###########....######..........#....###
###..##.....#########.........##########...#####..###########...########.........##.....##
###..........######...........##########...#####..##########...#########..........###...##
###..........######..........#########....######...########....#########..........########
###...........#####............#######....#######..######......#######..........##########
####..........######...........#########..#######...##..#......######..#........##########
#####.........#######..........########..##########...............###..#........##########
#####.........#####...........########..###########...............#######.........########
#####.........##..#...........##.......###############............##########......########
#####.............###.................##...#################..##############.....#########
#####.............###...........######.....###########################..##..#...##########
######............###.........##..........###########################.......#...##########
#######...........##.........##.....##..################....#######.........#...##########
#######..........###.........##...#####.################....#######.........##..##########
#####.............#..........##########..###############....#######.........###...##...###
###..........................###########.#################..#######.........#####.......##
##...........................###########....###############..#####..........######......##
##...........................###########....################.#####..........#####.......##
##............####...........############....###############..########..##..............##
##............#######........#############......#############.#############.#######.....##
##....#.......######........#############.......#############.#######.......#####.......##
##............######......###############......##############..###...........####.##....##
##............######.....#################......#############..#..............##..##....##
##........#..##################################..######..........######.......##..####..##
##...######.####################################........###############........#..#####.##
##....#####.#####################################.......###############........#..#####.##
####..##....######################################....#..###############.......########.##
####..##....######################################.##....###############.......########.##
#######.....###################....##############..###...#################..###########.##
#######.....########..######..#....####...#######.#####...#############################.##
######......###........#####..#...##......#######.#######.#############################.##
###....................####...#...#..#....######..#######..##..####..##################.##
##............................#..##.###...........########.....####...#################.##
##...........................##..##..............########......####....##..######........#
##...........................##..................########.......###.........####.........#
##...........................##.................##########......###.........###..........#
##...........................###.......#........##########.......#..........###..........#
##...........................###.................##############..#..........###..........#
###..........................###.....##..........###############............###..........#
####........######...........#####..#######....##################...........###.........##
####.......########..........#####....#############################.........###.........##
####.......##########........#####.......##########################.........##.........###
####......###########........####...........#########...#################...##.........###
####.....##########..........####...........######.......###############....###........###
#######..##########...####...#####..........######.......#############.......#.........###
##################...#####...#######...#..#######.........############.......#.........###
##################...######..#######...##########.........###########........#.........###
##################....###############..##########..........#########.......###.........###
###################...###############..###########.........#######..........##.........###
##################....###############..########..........########...........##.........###
##################...##########################..........########..........####........###
##################...#########..###############..............####..........####........###
##################..##########..############..........#.......##...........####........###
##################..##########...###########...........###..................###........###
##################....########....#########.............##...................##........###
#################.....#########.............######......##....................#........###
################..###.#.....###......####..#######......##....................#........###
################.####........##......####..#######......###...................#.......####
#####...#######..####........#####...#############.....####...................#...########
#####...........#####........######.##############......###...................###..#######
#####..######...#####........######.##############......###...................####.#######
####...######....#####.......#####..##############......###...................####..######
####...########..#####.......###....###############...######.................######..#####
####...########..#####.......###...#########################....###.......##########.#####
####...########..#######.....##....#######################......#####...############..####
####..#########################......#####################.......###################....##
####.##########################...##........##############........#############.........##
####.##################################.....##############........############..........##
####.#####################################################........############..........##
####.######################################################...##..#############.........##
####..##########################################################################.......###
####..###########################################################...############....######
####.##########################......#######################..#.....############....######
####.##########################.##......################...........######...####....######
####.#########################..###..##...##############........#..######.....##........##
###..###......#######.....###..########...##############........########......##........##
###..###.........##...........########.....#############.......#########......###.......##
###..####.........#........##########.......###########........#########......####......##
###..###...................#########........##########.........#########......####.....###
###..###.....................#######........#########.........#########.......####.....###
####.###.....................########.........#####..........##########.......#####...####
####.###.....................########........................#########........####....####
####..###....................########.......................########..........###....#####
#####.###....................########......................#######............###...######
#####...#........................####....................#######..........##..###..#######
######.............................##...................########..................########
#######.............................#........#..........########......#.........##########
#######....####################.....###############.....########......##......############
##########################################################################################