#############################################################
#############################################################
#############################################################
########################.........############################
#####################............############################
#####################.......##............###################
#####################......##...............#################
#####################.....###................################
##############...###......###............#...################
#############.............####..........###..################
############..............######........#####################
###########..............#######......#######################
##########...............######.....#########################
##########...............######.....#########################
############..............####......#########################
##############........##..###.......############....#########
##########..##...........##.........############.....########
##########..............###........#############......#######
###########.............####..........##########......#######
############.......#....####........#...########.......######
############.......##...####......#####..####..........######
############........#..#######...#######..##...........######
###########............##################..............######
#######................##################............########
######................###################.......#############
######..............######################......#############
######..............##########..##########..#...#############
#######.............##########..#############...#############
##########.........###########..#############..##############
############......########......#############################
#####..#######....#.....##......#############################
#####...#######.................#############################
#####.....#####.................######################..#####
#####.....######..............###############..######...#####
######.....######............###############...#####...######
######..........#......##...################...####....######
######..........##....###...###############...####.....######
#######.........#....####..#######...######....##.....#######
#######..............#####..####.......#..........#...#######
########...........########......................############
########........###########.....................#############
#########.......###########.....................#############
###########......##########.....##.............##############
###########......##########..#####.............##############
###########.....##################........###################
############....##################.......####################
#############....################......######################
################..###############....########################
################...##############...#########################
##################.....##########....########################
###################.....##########...########################
#####################...#####################################
#############################################################
#############################################################
#############################################################
#############################################################