#################################################################
#################################################################
#########..######################################################
###..........#############...##############...###################
###..........###########.....##############...###################
###..........###########.....##############...###################
###.........###########..###################.####################
###.......#############.####################.####################
###......############...####################..###################
###.....############....#####################....##########..####
####..##########........####################.....##########..####
####..##########........###################.....###########..####
####..##########......###########...#######.....###########.#####
#####..###...##......############...#######.....###########.#####
######..............#############...######......###########.#####
######...####......###########......######......###########.#####
######...#####.....#########......#############.#..########.#####
######..######....##########......#############.#..########.#####
####....#######..###########......#############....########...###
####..#########..########........#############.....########...###
################..#######........#############........####....###
#################..####........##################.......#.....###
##################............####################............###
##################...........#####################.........######
##################..........#########################...#########
##################.......#..##########..#############..##########
####################.....#..#####....#..#############..##########
###################......##.#####.......############...##########
###################.....###..###.........###########.############
#####################...####...................####..############
#################......####...............###..###..#############
################..#....###............#######.......#############
############.....##..#####...........########......##############
############....###..####............########......##############
#############..##########....#..##..##########.....##############
#######.....##.###############..##############.....##############
#######........###############..#############....################
#######.......################..############...##################
#######.......################...###########..###################
#######.......#################...##########..###################
###########...###################.....###########################
############.....#################....###########################
############.....################################################
#################################################################
#################################################################
#################################################################