#####################################
#####################################
#####.....###########################
#####.......#########################
#####.....#.....#####################
#####.....#####...........###.#######
#####.....#####.#####.###.##...######
#####.....#####.#......##.......#####
########.######.#......##.##...######
########.####...#......##.###.#######
########.####.###......##.###########
########.####.###......##....########
#####......##.###########.##.########
#####......##.###########.#.....#####
#####......##.####........#.....#####
#####......##.####......#.#.....#####
#####......##.####......#.#.....#####
#####......##.##........#.#.....#####
#####......##....#####.##.......#####
#####......#####.####.....#####.#####
#####......###......#.#########.#####
#####......###......#.##........#####
##############......#.##......#.#####
##############......#.........#.#####
########.....#.####.#.##......#..####
########.###...........#......##.####
######...######.######.#####.###.####
######.#####.....#####.#####..##.####
#####.....##.....####.....###....####
#####.....##.....###.......#####.####
#####.....##.....##.........####.####
#####.....##.....###.......#####.####
#####.....##.....####.....######.####
#####.....######.########.######.####
################.......##.####...####
######################.........######
#####################################
#####################################
#####################################
#####################################