...#.#.#.....#.#.#.#.#...#..#
.#.#.#.#..#....#.#..#.#....#.
#...#....#...#.#.#..#..#.#..#
.#.##.##.#.###.###.#...#...#.
##..#....#.#.#.##.#....#...#.
#.##...#.##.#.#..#...@..#.#.#
...#.#.#.....#.#.#.#.#...#..#
.#.#.#.#..#....#.#..#.#....#.
#...#....#...#.#.#..#..#.#..#
.#.##.##.#.###.###.#...#...#.
##..#....#.#.#.##.#.##.#...#.
#.##...#.##.#.#..#......#.#.#