.............................
.............................
.............................
............############.....
............#................
.......######@##########.....
.......#......#..............
.......#.######..............
.............................
.............................
.............................
.............................