.......................................######.....###################
.....................................#.######.......##......#########
.......................................##..##....##.#.......#########
....................................##.#...##....##.........#####...#
....................................##.#...##....######........##...#
........................................#..##....########......##...#
........................................##..##.......####....####...#
.........................................##..#........####....##...##
.........................................#............####....##....#
...........................................###..#..........#........#
..........................................#####...........###.....###
...........................................##...###......####.....###
...............................................#####...########...###
...........................................##..#####...##############
.........................................##........#..###############
.........................................##........#.################
........................................###...#....#....#############
................#####.##.....................###..#####.########..#..
..............#######.##.#..................###########..###.........
.............########.##.##.................############.............
............####......#..###...............######..#####.............
...........###..........#####..............####....######......###...
..........####.#......#.######.............####....######.....#######
.........#####.#......#.#######...............#....#####......#####..
...........###.########.#####....................#######......#####..
........##..##................##.........#......#########....#######.
........###.#####.######.#.#####.........#......#########.#########..
........##...............#.#####..........#...##########....####.....
........##.....##.#......#...###.............#.####..###....#.....###
........##.....#..#......###.###............##..###..####........####
...............#.##......##..###................####.######......####
........##.....#.##......##.####............#....##...#####......####
........##.....#.#####.####.####............#..........######.....###
........###.####.......####.####............#.....#....########...###
.........##......####.##....###..............######......######...#..
.........#######.#.....#.######................####......######.##...
..........######.#.....#.#####.................######....#####.......
...........#####.#.....#.####....................######...####....#..
............####.#.....#.###.............####.....#####....###....#..
.............###.........##...............###.....#######......#.##..
..............####.....###................##.......####....##....###.
................########...................#.......####..###########.
...................##...........................#........#########...
...................##.........................######.....#########...
....................#..................#.....#######....###########..
....................####......................####......####..#######
....................#######...................##........####....#####
......................####.............................####.....#####
......................####..................####...##..###......#####
........................##..................#####.####.###.....######
..................................................####.####...#######
....................................................##........#####..
....................................................##.......######..
..................................................####.#...#..####...
.................#................................####..#####..###...
.................................................#####..######......#